14	8
8	9	10	0	26	27	28	0	44	45	46	0	0	0
7	0	11	0	25	0	29	0	43	0	47	0	61	0
6	0	12	0	24	0	30	0	42	0	48	0	60	0
5	0	13	0	23	0	31	0	41	0	49	0	59	0
4	0	14	0	22	0	32	0	40	0	50	0	58	0
3	0	15	0	21	0	33	0	39	0	51	0	57	0
2	0	16	0	20	0	34	0	38	0	52	0	56	0
1	0	17	18	19	0	35	36	37	0	53	54	55	0
