8	14												
3	2	4	0	3	2	4	0	3	2	4	0	0	0
1	0	1	0	1	0	1	0	1	0	1	0	8	0
1	0	1	0	1	0	1	0	1	0	1	0	1	0
1	0	1	0	1	0	1	0	1	0	1	0	1	0
1	0	1	0	1	0	1	0	1	0	1	0	1	0
1	0	1	0	1	0	1	0	1	0	1	0	1	0
1	0	1	0	1	0	1	0	1	0	1	0	1	0
7	0	5	2	6	0	5	2	6	0	5	2	6	0
